5/10/3/2/3/6/RY
5/10/4/1/3/6/RY
5/10/5/1/3/6/RY
5/10/3/2/3/6/RY
5/10/3/2/3/6/RY
5/10/3/2/3/6/RY
5/10/3/2/3/6/RY
5/10/3/2/3/6/RY
5/10/3/2/3/6/RY
5/10/3/2/3/6/RY
5/10/3/2/3/6/RY
5/10/3/2/3/6/RY
5/10/3/2/3/6/RY